あいばあいな	相羽あいな	人名
あいみ	愛美	人名
あさひなまどか	朝比奈丸佳	人名
いとうあやさ	伊藤彩沙	人名
いとうみく	伊藤美来	人名
おおつかさえ	大塚紗英	人名
おおはしあやか	大橋彩香	人名
おざきゆか	尾崎由香	人名
おざわあり	小澤亜李	人名
かとうえみり	加藤英美里	人名
かねもとひさこ	金元寿子	人名
きったいずみ	橘田いずみ	人名
ぎぶゆうこ	儀武ゆう子	人名
くどうはるか	工藤晴香	人名
くらちれお	倉知玲鳳	人名
くろさわともよ	黒沢ともよ	人名
こはらりこ	小原莉子	人名
こやままみ	小山茉美	人名
さくらあやね	佐倉綾音	人名
さくらがわめぐ	櫻川めぐ	人名
ささきみこい	佐々木未来	人名
しざきかのん	志崎樺音	人名
すざきあや	洲崎綾	人名
たどころあずさ	田所あずさ	人名
つむぎりさ	紡木吏佐	人名
とくいそら	徳井青空	人名
とよたもえ	豊田萌絵	人名
なかがみいくみ	中上育実	人名
なかしまゆき	中島由貴	人名
なつめ	夏芽	人名
にしもとりみ	西本りみ	人名
はたさわこ	秦佐和子	人名
はしだいずみ	橋田いずみ	人名
ひかさようこ	日笠陽子	人名
ふくえんみさと	福圓美里	人名
ほんいずみりな	本泉莉奈	人名
まえしまあみ	前島亜美	人名
みさわさちか	三澤紗千香	人名
みもりすずこ	三森すずこ	人名
みなみさき	南 早紀	人名
よしだゆうり	吉田有里	人名
