とやま	戸山	姓
かすみ	香澄	名
とやまかすみ	戸山 香澄	人名
はなぞの	花園	姓
たえ	たえ	名
はなぞのたえ	花園 たえ	人名
うしごめ	牛込	姓
りみ	りみ	名
うしごめりみ	牛込 りみ	人名
やまぶき	山吹	姓
さあや	沙綾	名
やまぶきさあや	山吹 沙綾	人名
いちがや	市ヶ谷	姓
ありさ	有咲	名
いちがやありさ	市ヶ谷 有咲	人名
みなと	湊	姓
ゆきな	友希那	名
みなとゆきな	湊 友希那	人名
ひかわ	氷川	姓
さよ	紗夜	名
ひかわさよ	氷川 紗夜	人名
いまい	今井	姓
りさ	リサ	名
いまいりさ	今井 リサ	人名
うだがわ	宇田川	姓
あこ	あこ	名
うだがわあこ	宇田川 あこ	人名
しろかね	白金	姓
りんこ	燐子	名
しろかねりんこ	白金 燐子	人名
みたけ	美竹	姓
らん	蘭	名
みたけらん	美竹 蘭	人名
あおば	青葉	姓
もか	モカ	名
あおばもか	青葉 モカ	人名
うえはら	上原	姓
ひまり	ひまり	名
うえはらひまり	上原 ひまり	人名
うだがわ	宇田川	姓
ともえ	巴	名
うだがわともえ	宇田川 巴	人名
はざわ	羽沢	姓
つぐみ	つぐみ	名
はざわつぐみ	羽沢 つぐみ	人名
まるやま	丸山	姓
あや	彩	名
まるやまあや	丸山 彩	人名
ひかわ	氷川	姓
ひな	日菜	名
ひかわひな	氷川 日菜	人名
しらさぎ	白鷺	姓
ちさと	千聖	名
しらさぎちさと	白鷺 千聖	人名
やまと	大和	姓
まや	麻弥	名
やまとまや	大和 麻弥	人名
わかみや	若宮	姓
いぶ	イヴ	名
わかみやいヴ	若宮 イヴ	人名
つるまき	弦巻	姓
こころ	こころ	名
つるまきこころ	弦巻 こころ	人名
せた	瀬田	姓
かおる	薫	名
せたかおる	瀬田 薫	人名
きたざわ	北沢	姓
はぐみ	はぐみ	名
きたざわはぐみ	北沢 はぐみ	人名
まつばら	松原	姓
かのん	花音	名
まつばらかのん	松原 花音	人名
おくざわ	奥澤	姓
みさき	美咲	名
おくさわみさき	奥沢 美咲	人名
みっしぇる	奥沢 美咲	人名
つきしま	月島	姓
まりな	まりな	名
つきしままりな	月島 まりな	人名
とやま	戸山	姓
あすか	明日香	名
とやまあすか	戸山 明日香	人名
あさひ	朝日	姓
ろっか	六花	名
あさひろっか	朝日 六花	人名

うしごめ	牛込	姓
ゆり	ゆり	名
うしごめゆり	牛込 ゆり	人名
うざわ	鵜沢	姓
りぃ	りぃ	名
うざわりぃ	鵜沢 リィ	人名
わにべ	鰐部	姓
ななな	七菜	名
わにべななな	鰐部 七菜	人名
にじっき	二十騎	姓
ひなこ	ひなこ	名
にじっきひなこ	二十騎 ひなこ	人名

かわばた	川端	姓
まゆ	真結	名
かわばたまゆ	川端 真結	人名
もり	森	姓
ふみか	文華	名
もりふみか	森 文華	人名
たいこ	大湖	姓
さとみ	里実	名
たいこさとみ	大湖 里実	人名
うみの	海野	姓
なつき	夏希	名
うみのなつき	海野 夏希	人名

つづき	都築	姓
しふね	詩船	名
つづきしふね	都築 詩船	人名
まつぎ	真次	姓
りりこ	凛々子	名
まつぎりりこ	真次 凛々子	人名
